acon	No
acpi	No
acpid	No
adsl	No
alsa	No
anacron	No
apmd	No
apmiser	No
arpwatch	No
atd	No
autofs	No
bluetooth	No
bootparamd	No
canna	No
capi4linux	No
cpqarrayd	No
cpufreq	No
cpufreqd	No
crond	Yes
cups-lpd	No
cups	Yes
cvs	No
devfsd	No
dhcpd	No
diald	No
dkms	No
dm	Yes
dnbc	No
drakxtools_http	No
dund	No
fam	No
finger	No
freshclam	Yes
gpm	Yes
haldaemon	No
harddrake	No
heartbeat	No
hidd	No
hplip	No
hpoj	No
httpd	No
hylafax?server	No
ibod	No
identd	No
imaps	No
imaps	No
iplog	No
ipop2	No
ipop3	No
ipsec	No
iptables	Yes
ipvsadmin	No
irda	No
keytable	Yes
kheader	No
lads	No
laptop?mode	No
leafnode	No
lisa	No
lmsensors	No
mailman	No
mandi	No
mdadm	No
mdnsresponder	No
messagebus	Yes
mon	Yes
mysqld	No
named	No
netplugd	No
network	Yes
nfs	No
nfsfs	No
nfslock	No
nifd	No
nscd	No
ntpd	No
numlock	No
oki4daemon	No
pand	No
partmon	Yes
pcmcia	No
pg_autovacum	No
pop3s	No
portmap	No
Postgresql	No
postfix	No
pptp	No
prelude	No
psacct	No
rawdevices	Yes
rsync	No
saned	No
shorwall	Yes
smartd	No
smb	No
snmpd	No
sound	No
squid	No
ssh?xinetd	No
sshd	No
subversion	No
swat	No
syslog	Yes
tmdns	No
ultrabayed	No
upsd	No
upsmon	No
vncserver	No
Webmin	No
winbind	No
wine	No
wlan	No
x?inetd	Yes
xfs	Yes
ypbind	No

